R 10 10
NO ./assets/textures/Coal.xpm
SO ./assets/textures/Bricks.xpm
WE ./assets/textures/bark.xpm
EA ./assets/textures/bookshelf.xpm

S ./greenlight.xpm
F 64,255,0
C 0,191,255

11111111111111111111111111111111111111111
11111010000000000110101010111111111111111
11100000000000000000000000111111111111111
11111111000111111111111111111111111111111
11100000000111111111111111111111111111111
11100000001111111111111111111111111111111
11100000000000000000000000111111111111111
11100000000000001111111111111111111111111
11100000000000000000000000111111111111111
11100000000000000000000000111111111111111
11100000000000000000000000111111111111111
11100000000000000001111111111111111111111
11100000000111111111111111111111111111111
11100000000000000000000000111111111111111
11100000000000000000000000111111111111111
11100000000000000000000000011111111111111
11100000000000000000000000111111111111111
11100000000000000000000000111111111111111
11111111111111111111111111111111111111111
11111111111111111111111111111111111111111
11111111111111111111111111111111111111111
11111111111111111111111111111111111111111
11111111111111111111111111111111111111111