R 800 800
NO ./assets/textures/Coal.xpm
SO ./assets/textures/Bricks.xpm
WE ./assets/textures/bark.xpm
EA ./assets/textures/bookshelf.xpm

S ./assets/textures/sprites/greenlight.xpm

S ./assets/textures/sprites/pika/1.xpm
- ./assets/textures/sprites/pika/2.xpm
- ./assets/textures/sprites/pika/3.xpm
- ./assets/textures/sprites/pika/4.xpm
- ./assets/textures/sprites/pika/5.xpm
- ./assets/textures/sprites/pika/6.xpm
- ./assets/textures/sprites/pika/7.xpm
- ./assets/textures/sprites/pika/8.xpm
- ./assets/textures/sprites/pika/9.xpm
- ./assets/textures/sprites/pika/10.xpm
- ./assets/textures/sprites/pika/11.xpm
- ./assets/textures/sprites/pika/12.xpm
- ./assets/textures/sprites/pika/13.xpm
- ./assets/textures/sprites/pika/14.xpm
- ./assets/textures/sprites/pika/15.xpm
- ./assets/textures/sprites/pika/16.xpm

F 64,255,0
C 0,191,255

11111111111111111111111111111111111111
111111111111111111111111111111111111111
11100000000000000000000000111111111111111
11100000000000000000000000111111111111111
111000000000010000000000000111111111111111
111000000000000002000000000111111111111111
11100000000000000000000000111111111111111
11100000000000000000000000111111111111111
111000000000000020000000000111111111111111
11100000000000000000000000111111111111111
111000000000N0000000000000111111111111111
111000000200000000000000000111111111111111
1110000000000002000000000000111111111111111
11100000000000000000000000111111111111111
11100000000000000000000000111111111111111
11100000000000000000000000111111111111111
111000000000002000000000000111111111111111
11100000000000000000000000111111111111111
11100000000000000000000000111111111111111
11100000000000000000000000111111111111111
11100000000000000000000000111111111111111
11100000000000000000000000111111111111111
11111111111111111111111111111111111111111